NO ./images/w_n.png
SO ./images/w_n.png
WE ./images/w_n.png
EA ./images/w_n.png
DO ./images/door.png

F 0,64,0
C 0,0,0

        111111111111111111111111
        1000000000110000000000001
        1211000001110000000000001
        1001000000200000000000001
111111111211000001110000000000001
100000000011000001112111112111111
11112111111111211100000010001
11110111111111011101010010001
11000000110101011100000010001
10000000000000001100000010001
1000N000000000001101010010001
1100000111012121111121111000111
11010111 1110101 100011000001
11211111 1111111 111111211111
 101                  101
1000111111111111111111121
1000101000102010000000001
1000000010101020101010101
1000101000201010000000001
1111111111111011111111111
            121
            101
        11111011111
        10000000001
    111110000000001
    10020000010001
    111110000000001
        10000000001
        11111111111
