NO ./images/w_n.png
SO ./images/w_n.png
WE ./images/w_n.png
EA ./images/w_n.png

F 0,64,0
C 0,0,0

        111111111111111111111111
        1000000000110000000000001
        1011000001110000000000001
        1001000000000000000000001
111111111011000001110000000000001
100000000011000001110111110111111
11110111111111011100000010001
11110111111111011101010010001
11000000110101011100000010001
10000000000000001100000010001
1000N000000000001101010010001
1100000111010101111101111000111
11010111 1110101 100011000001
11011111 1111111 111111011111
 101                  101
1000111111111111111111101
1000101000100010000000001
1000000010101010101010101
1000101000001000000000001
1111111111111011111111111
            101
            101
        11111011111
        10000000001
    111110000000001
    10000000010001
    111110000000001
        10000000001
        11111111111
