F 0,64,0
C 0,0,0

111111111111111111111111111111111111111111111111111111111111
100000000000000000000000000000000000000000000000000000000001
101111111111111111111111111111111111111111111111111111110101
100000000000000000000000000000000000000000000000000000010001
101011111111111111111111111111111111111111111111111101101101
100010000000000000000000000000000000000000000000000000000001
101010111101010111111111111111110000000000000000000100001001
100000000000000000000000000000000000000000000000000000100001
10101111111111111111111000N000111111111111111111110000100001
100000000000000000000000000000000000000000000000000000000001
101011101110000111111111000001010000000000000000000000000001
100000000000000000000000000000000000000000000000000000001101
101011111111111111111111111111111111111111111111110001000001
100000000000000000000000000000000000000000000000000000001101
101010111101010111111111111111111111111111111111110100101101
100000000000000000000000000000000000000000000000000000000101
101111111111111111111111111111111111111111111111111111111111
100000000000000000000000000000000000000000000000000000000001
111111111111111111111111111111111111111111111111111111111111